Directions: To play this game, go north, south, east, or west. You may look at certain things, but they do not aid you in progressing through the story.

Gaea's Cradle
Tall old trees surround you, towering over the sky, watching over the bending path. The bending path continues north for miles ahead. To the west, among the path, you see an old shrine. Behind you is your hometown, Allune. To your right in the East, you see a long beaten trail that goes deep into the woods.

>east
The Beaten Path
It's a dirty, beaten path that looks like it leads somewhere.

>east
The Thieve's Den
A dilapidated building in the middle of the forest.

You can see a Thief here.

    *** The Theif has stopped you. You suddenly feel light headed... The Theif has stabbed you! He steals all your stuff as you begin to bleed out into white... ***

Would you like to RESTART, RESTORE a saved game, QUIT, or UNDO the last command?

>east
You can't go that way.

>north
You can't go that way.

>west
The Beaten Path

* * *

>east
The Thieve's Den
A dilapidated building in the middle of the forest.

You can see a Thief here.

    *** The Theif has stopped you. You suddenly feel light headed... The Theif has stabbed you! He steals all your stuff as you begin to bleed out into white... ***

Would you like to RESTART, RESTORE a saved game, QUIT, or UNDO the last command?

>talk to thief
That's not a verb I recognize.

>look
The Thieve's Den
A dilapidated building in the middle of the forest.

You can see a Thief here.

>x thief
Someone who wants to rob you!

* * *

>east
The Thieve's Den
A dilapidated building in the middle of the forest.

You can see a Thief here.

    *** The Theif has stopped you. You suddenly feel light headed... The Theif has stabbed you! He steals all your stuff as you begin to bleed out into white... ***

Would you like to RESTART, RESTORE a saved game, QUIT, or UNDO the last command?

>restart
Directions: To play this game, go north, south, east, or west. You may look at certain things, but they do not aid you in progressing through the story.

Gaea's Cradle
Tall old trees surround you, towering over the sky, watching over the bending path. The bending path continues north for miles ahead. To the west, among the path, you see an old shrine. Behind you is your hometown, Allune. To your right in the East, you see a long beaten trail that goes deep into the woods.

>eat fruit
You can't see any such thing.

>inventory
You are carrying:
  a backpack (open)
    an apple
    a letter
  a silver key

>eat an apple
That's plainly inedible.

>eat apple
That's plainly inedible.

You were attacked by a boar!

* * *

Directions: To play this game, go north, south, east, or west. You may look at certain things, but they do not aid you in progressing through the story.

Gaea's Cradle
Tall old trees surround you, towering over the sky, watching over the bending path. The bending path continues north for miles ahead. To the west, among the path, you see an old shrine. Behind you is your hometown, Allune. To your right in the East, you see a long beaten trail that goes deep into the woods.

>north
Gaea's End
The end of the forest that leads a lavish city.

You were attacked by a boar!

>north
Lynesera
The path from the south ends at the silver gates, leading to a path into a city built into the base of a large Deku tree.

You can see Grandmother here.

    *** You met your Grandmother. ***

Would you like to RESTART, RESTORE a saved game, QUIT, or UNDO the last command?

>look at tree
Please give one of the answers above.

Would you like to RESTART, RESTORE a saved game, QUIT, or UNDO the last command?

>restart
Directions: To play this game, go north, south, east, or west. You may look at certain things, but they do not aid you in progressing through the story.

Gaea's Cradle
Tall old trees surround you, towering over the sky, watching over the bending path. The bending path continues north for miles ahead. To the west, among the path, you see an old shrine. Behind you is your hometown, Allune. To your right in the East, you see a long beaten trail that goes deep into the woods.

>look at tree
Magic oak trees covering your view of the sky with old, grown branches.

>look at shrine
You can't see any such thing.

* * *

Directions: To play this game, go north, south, east, or west. You may look at certain things, but they do not aid you in progressing through the story.

Gaea's Cradle
Tall old trees surround you, towering over the sky, watching over the bending path. The bending path continues north for miles ahead. To the west, among the path, you see an old shrine. Behind you is your hometown, Allune. To your right in the East, you see a long beaten trail that goes deep into the woods.

>eat apple
(first taking the apple)
You eat the apple. Not bad.

You were attacked by a boar!

>west
You cannot go there. But you can admire the shrine.

>east
The Beaten Path
It's a dirty, beaten path that looks like it leads somewhere.

>west
Gaea's Cradle

>north
Gaea's End
The end of the forest that leads a lavish city.

>south
Gaea's Cradle

>south
You take a few steps towards your hometown, but remembering that you have to see Grandmother, you return to the path.

You are startled by a bird and run into a tree.

* * *

Directions: To play this game, go north, south, east, or west. You may look at certain things, but they do not aid you in progressing through the story.

Gaea's Cradle
Tall old trees surround you, towering over the sky, watching over the bending path. The bending path continues north for miles ahead. To the west, among the path, you see an old shrine. Behind you is your hometown, Allune. To your right in the East, you see a long beaten trail that goes deep into the woods.

>south
You take a few steps towards your hometown, but remembering that you have to see Grandmother, you return to the path.

>south
You take a few steps towards your hometown, but remembering that you have to see Grandmother, you return to the path.

>south
You take a few steps towards your hometown, but remembering that you have to see Grandmother, you return to the path.

You are startled by a bird and run into a tree.

>outh
That's not a verb I recognize.

* * *

>south
You take a few steps towards your hometown, but remembering that you have to see Grandmother, you return to the path.

>west
You cannot go there. But you can admire the shrine.

>west
You cannot go there. But you can admire the shrine.

>south
You take a few steps towards your hometown, but remembering that you have to see Grandmother, you return to the path.

>east
The Beaten Path
It's a dirty, beaten path that looks like it leads somewhere.

>south
You can't go that way.

You were attacked by a boar!

* * *

>south
You take a few steps towards your hometown, but remembering that you have to see Grandmother, you return to the path.

>outh
That's not a verb I recognize.

>south
You take a few steps towards your hometown, but remembering that you have to see Grandmother, you return to the path.

* * *

>east
The Beaten Path
It's a dirty, beaten path that looks like it leads somewhere.

>e
The Thieve's Den
A dilapidated building in the middle of the forest.

You can see a Thief here.

    *** The Theif has stopped you. You suddenly feel light headed... The Theif has stabbed you! He steals all your stuff as you begin to bleed out into white... ***

Would you like to RESTART, RESTORE a saved game, QUIT, or UNDO the last command?

>e
Please give one of the answers above.

Would you like to RESTART, RESTORE a saved game, QUIT, or UNDO the last command?

>restart
Directions: To play this game, go north, south, east, or west. You may look at certain things, but they do not aid you in progressing through the story.

Gaea's Cradle
Tall old trees surround you, towering over the sky, watching over the bending path. The bending path continues north for miles ahead. To the west, among the path, you see an old shrine. Behind you is your hometown, Allune. To your right in the East, you see a long beaten trail that goes deep into the woods.

>w
You cannot go there. But you can admire the shrine.

>w
You cannot go there. But you can admire the shrine.

I beg your pardon?

>w
You cannot go there. But you can admire the shrine.

>w
You cannot go there. But you can admire the shrine.

Ouch! You tripped on a rock.

*** Run-time problem P31: Attempt to use a property of the 'nothing' non-object: property current health

I beg your pardon?

* * *

>east
The Beaten Path
It's a dirty, beaten path that looks like it leads somewhere.

>south
You can't go that way.

>west
Gaea's Cradle

>west
You cannot go there. But you can admire the shrine.

* * *

>south
You take a few steps towards your hometown, but remembering that you have to see Grandmother, you return to the path.

>sout
That's not a verb I recognize.

>south
You take a few steps towards your hometown, but remembering that you have to see Grandmother, you return to the path.

>south
You take a few steps towards your hometown, but remembering that you have to see Grandmother, you return to the path.

You are startled by a bird and run into a tree.

*** Run-time problem P31: Attempt to use a property of the 'nothing' non-object: property current health

* * *

Directions: To play this game, go north, south, east, or west. You may look at certain things, but they do not aid you in progressing through the story.

Gaea's Cradle
Tall old trees surround you, towering over the sky, watching over the bending path. The bending path continues north for miles ahead. To the west, among the path, you see an old shrine. Behind you is your hometown, Allune. To your right in the East, you see a long beaten trail that goes deep into the woods.

>norht
That's not a verb I recognize.

>north
Gaea's End
The end of the forest that leads a lavish city.

>north
Lynesera
The path from the south ends at the silver gates, leading to a path into a city built into the base of a large Deku tree.

You can see Grandmother here.

    *** You met your Grandmother. ***

Would you like to RESTART, RESTORE a saved game, QUIT, or UNDO the last command?

>restart
Directions: To play this game, go north, south, east, or west. You may look at certain things, but they do not aid you in progressing through the story.

Gaea's Cradle
Tall old trees surround you, towering over the sky, watching over the bending path. The bending path continues north for miles ahead. To the west, among the path, you see an old shrine. Behind you is your hometown, Allune. To your right in the East, you see a long beaten trail that goes deep into the woods.

>south
You take a few steps towards your hometown, but remembering that you have to see Grandmother, you return to the path.

Ouch! You tripped on a rock.

* * *

Directions: To play this game, go north, south, east, or west. You may look at certain things, but they do not aid you in progressing through the story.

Gaea's Cradle
Tall old trees surround you, towering over the sky, watching over the bending path. The bending path continues north for miles ahead. To the west, among the path, you see an old shrine. Behind you is your hometown, Allune. To your right in the East, you see a long beaten trail that goes deep into the woods.

>e
The Beaten Path
It's a dirty, beaten path that looks like it leads somewhere.

>w
Gaea's Cradle

>w
You cannot go there. But you can admire the shrine.

You were attacked by a boar!

*** Run-time problem P31: Attempt to use a property of the 'nothing' non-object: property current health

* * *

Directions: To play this game, go north, south, east, or west. You may look at certain things, but they do not aid you in progressing through the story.

Gaea's Cradle
Tall old trees surround you, towering over the sky, watching over the bending path. The bending path continues north for miles ahead. To the west, among the path, you see an old shrine. Behind you is your hometown, Allune. To your right in the East, you see a long beaten trail that goes deep into the woods.

>w
You cannot go there. But you can admire the shrine.

* * *

I beg your pardon?

>w
You cannot go there. But you can admire the shrine.

Ouch! You tripped on a rock.

>w
You cannot go there. But you can admire the shrine.

>restart
Are you sure you want to restart?

Please answer yes or no.

>y
Directions: To play this game, go north, south, east, or west. You may look at certain things, but they do not aid you in progressing through the story.

Gaea's Cradle
Tall old trees surround you, towering over the sky, watching over the bending path. The bending path continues north for miles ahead. To the west, among the path, you see an old shrine. Behind you is your hometown, Allune. To your right in the East, you see a long beaten trail that goes deep into the woods.

>s
You take a few steps towards your hometown, but remembering that you have to see Grandmother, you return to the path.

>s
You take a few steps towards your hometown, but remembering that you have to see Grandmother, you return to the path.

>s
You take a few steps towards your hometown, but remembering that you have to see Grandmother, you return to the path.

Ouch! You tripped on a rock.

I beg your pardon?

>s
You take a few steps towards your hometown, but remembering that you have to see Grandmother, you return to the path.

* * *

Directions: To play this game, go north, south, east, or west. You may look at certain things, but they do not aid you in progressing through the story.

Gaea's Cradle
Tall old trees surround you, towering over the sky, watching over the bending path. The bending path continues north for miles ahead. To the west, among the path, you see an old shrine. Behind you is your hometown, Allune. To your right in the East, you see a long beaten trail that goes deep into the woods.

>s
You take a few steps towards your hometown, but remembering that you have to see Grandmother, you return to the path.

>restart
Directions: To play this game, go north, south, east, or west. You may look at certain things, but they do not aid you in progressing through the story.

Gaea's Cradle
Tall old trees surround you, towering over the sky, watching over the bending path. The bending path continues north for miles ahead. To the west, among the path, you see an old shrine. Behind you is your hometown, Allune. To your right in the East, you see a long beaten trail that goes deep into the woods.

>s
You take a few steps towards your hometown, but remembering that you have to see Grandmother, you return to the path.

You were attacked by a boar!

    *** You have sustained too many injuries. You have died. ***

Would you like to RESTART, RESTORE a saved game, QUIT, or UNDO the last command?

>restart
Directions: To play this game, go north, south, east, or west. You may look at certain things, but they do not aid you in progressing through the story.

Gaea's Cradle
Tall old trees surround you, towering over the sky, watching over the bending path. The bending path continues north for miles ahead. To the west, among the path, you see an old shrine. Behind you is your hometown, Allune. To your right in the East, you see a long beaten trail that goes deep into the woods.

>s
You take a few steps towards your hometown, but remembering that you have to see Grandmother, you return to the path.

>s
You take a few steps towards your hometown, but remembering that you have to see Grandmother, you return to the path.

You were attacked by a boar!

    *** You have sustained too many injuries. You have died. ***

Would you like to RESTART, RESTORE a saved game, QUIT, or UNDO the last command?

* * *

>s
You take a few steps towards your hometown, but remembering that you have to see Grandmother, you return to the path.

>s
You take a few steps towards your hometown, but remembering that you have to see Grandmother, you return to the path.

You are startled by a bird and run into a tree.

>s
You take a few steps towards your hometown, but remembering that you have to see Grandmother, you return to the path.

>s
You take a few steps towards your hometown, but remembering that you have to see Grandmother, you return to the path.

Ouch! You tripped on a rock.

    *** You have sustained too many injuries. You have died. ***

Would you like to RESTART, RESTORE a saved game, QUIT, or UNDO the last command?

>s
Please give one of the answers above.

Would you like to RESTART, RESTORE a saved game, QUIT, or UNDO the last command?

* * *

>s
You take a few steps towards your hometown, but remembering that you have to see Grandmother, you return to the path.

>eat apple
(first taking the apple)
You eat the apple. Not bad.

>inventory
You are carrying:
  a backpack (open)
    a letter
  a silver key

>read letter
You see nothing special about the letter.

>x
What do you want to examine?

>floor
You can't see any such thing.

>look
Gaea's Cradle
Tall old trees surround you, towering over the sky, watching over the bending path. The bending path continues north for miles ahead. To the west, among the path, you see an old shrine. Behind you is your hometown, Allune. To your right in the East, you see a long beaten trail that goes deep into the woods.

>x trees
Magic oak trees covering your view of the sky with old, grown branches.

>x magic
You can't see any such thing.

>x branches
Magic oak trees covering your view of the sky with old, grown branches.

Ouch! You tripped on a rock.

    *** You have sustained too many injuries. You have died. ***

Would you like to RESTART, RESTORE a saved game, QUIT, or UNDO the last command?

>restart
Directions: To play this game, go north, south, east, or west. You may look at certain things, but they do not aid you in progressing through the story.

Gaea's Cradle
Tall old trees surround you, towering over the sky, watching over the bending path. The bending path continues north for miles ahead. To the west, among the path, you see an old shrine. Behind you is your hometown, Allune. To your right in the East, you see a long beaten trail that goes deep into the woods.

* * *

>s
You take a few steps towards your hometown, but remembering that you have to see Grandmother, you return to the path.

>look
Gaea's Cradle
Tall old trees surround you, towering over the sky, watching over the bending path. The bending path continues north for miles ahead. To the west, among the path, you see an old shrine. Behind you is your hometown, Allune. To your right in the East, you see a long beaten trail that goes deep into the woods.

>east
The Beaten Path
It's a dirty, beaten path that looks like it leads somewhere.

>x path
You can't see any such thing.

>look
The Beaten Path
It's a dirty, beaten path that looks like it leads somewhere.

>w
Gaea's Cradle

>look
Gaea's Cradle
Tall old trees surround you, towering over the sky, watching over the bending path. The bending path continues north for miles ahead. To the west, among the path, you see an old shrine. Behind you is your hometown, Allune. To your right in the East, you see a long beaten trail that goes deep into the woods.

* * *

>eat apple
(first taking the apple)
You eat the apple. Not bad.

>e
The Beaten Path
It's a dirty, beaten path that looks like it leads somewhere.

You are startled by a bird and run into a tree.

>e
The Thieve's Den
A dilapidated building in the middle of the forest.

You can see a Thief here.

You were attacked by a boar!

    *** The Theif has stopped you. You suddenly feel light headed... The Theif has stabbed you! He steals all your stuff as you begin to bleed out into white... ***

Would you like to RESTART, RESTORE a saved game, QUIT, or UNDO the last command?

>restart
Directions: To play this game, go north, south, east, or west. You may look at certain things, but they do not aid you in progressing through the story.

Gaea's Cradle
Tall old trees surround you, towering over the sky, watching over the bending path. The bending path continues north for miles ahead. To the west, among the path, you see an old shrine. Behind you is your hometown, Allune. To your right in the East, you see a long beaten trail that goes deep into the woods.

You can see a raspberry here.

* * *

>s
You take a few steps towards your hometown, but remembering that you have to see Grandmother, you return to the path.

>look tree
Magic oak trees covering your view of the sky with old, grown branches.

>look branches
Magic oak trees covering your view of the sky with old, grown branches.

You were attacked by a boar!

>eat apple
(first taking the apple)
You eat the apple. Not bad.

>n
Gaea's End
The end of the forest that leads a lavish city.

>n
Lynesera
The path from the south ends at the silver gates, leading to a path into a city built into the base of a large Deku tree.

You can see Grandmother here.

    *** You met your Grandmother. ***

Would you like to RESTART, RESTORE a saved game, QUIT, or UNDO the last command?

>restart
Directions: To play this game, go north, south, east, or west. You may look at certain things, but they do not aid you in progressing through the story.

Gaea's Cradle
Tall old trees surround you, towering over the sky, watching over the bending path. The bending path continues north for miles ahead. To the west, among the path, you see an old shrine. Behind you is your hometown, Allune. To your right in the East, you see a long beaten trail that goes deep into the woods.

>e
The Beaten Path
It's a dirty, beaten path that looks like it leads somewhere.

>s
You can't go that way.

>w
Gaea's Cradle

>w
You cannot go there. But you can admire the shrine.

You were attacked by a boar!

>eat apple
(first taking the apple)
You eat the apple. Not bad.

>look at shrine
You can't see any such thing.

>x shrine
You can't see any such thing.

* * *

Directions: To play this game, go north, south, east, or west. You may look at certain things, but they do not aid you in progressing through the story.

Gaea's Cradle
Tall old trees surround you, towering over the sky, watching over the bending path. The bending path continues north for miles ahead. To the west, among the path, you see an old shrine. Behind you is your hometown, Allune. To your right in the East, you see a long beaten trail that goes deep into the woods.

>west
Shrine
The broken shrine appears to be old and covered in moss.

>east
Gaea's Cradle

>climb tree
The forest grows ominous. You begin to hear the ground rumbling in the distance. You begin to panic.

>n
Gaea's End
The end of the forest that leads a lavish city.

* * *

Directions: To play this game, go north, south, east, or west. You may look at certain things, but they do not aid you in progressing through the story.

Gaea's Cradle
Tall old trees surround you, towering over the sky, watching over the bending path. The bending path continues north for miles ahead. To the west, among the path, you see an old shrine. Behind you is your hometown, Allune. To your right in the East, you see a long beaten trail that goes deep into the woods.

>inventory
You are carrying:
  a backpack (open)
    an apple
    a letter
  a silver key

>x letter
Your grandmother who lives in Lynesera. She wrote to you to come and visit because she misses you dearly.