CSC 378 Project 1
An Interactive Fiction by Koichi
Release 1 / Serial number 220111 / Inform 7 build 6M62 (I6/v6.33 lib 6/12N) SD

Front Porch
There is an abandoned house in front of you. All the windows and doors are boarded up. There seems to be no entry from this side of the house.

>take house
That's hardly portable.

* * *

CSC 378 Project 1
An Interactive Fiction by Koichi
Release 1 / Serial number 220111 / Inform 7 build 6M62 (I6/v6.33 lib 6/12N) SD

Front Porch
There is an abandoned house in front of you. All the windows and doors are boarded up. There seems to be no entry from this side of the house.

>take hosue
You can't see any such thing.

>take house
That's hardly portable.

* * *

CSC 378 Project 1
An Interactive Fiction by Koichi
Release 1 / Serial number 220111 / Inform 7 build 6M62 (I6/v6.33 lib 6/12N) SD

Front Porch
There is an abandoned house in front of you. All the windows and doors are boarded up. There seems to be no entry from this side of the house.

>w
West side of the House
You are facing the West side of the house. There are windows but they are boarded up.

* * *

CSC 378 Project 1
An Interactive Fiction by Koichi
Release 1 / Serial number 220111 / Inform 7 build 6M62 (I6/v6.33 lib 6/12N) SD

Front Porch
There is an abandoned house in front of you. All the windows and doors are boarded up. There seems to be no entry from this side of the house.

>west
West side of the House
You are facing the West side of the house. Windows are boarded up on this side too. Gotta be some way in.

>west
You can't go that way.

>east
Front Porch
There is an abandoned house in front of you. All the windows and doors are boarded up. There seems to be no entry from this side of the house.

>east
East side of the House
 A couple racoons scurry away as you turn the corner.  You are facing the East side of the house. There is a knocked over trash can that the racoons were looting.

>x trash can
There is only rotten food and a rusty knife in here.

In trash can is a knife.

* * *

CSC 378 Project 1
An Interactive Fiction by Koichi
Release 1 / Serial number 220111 / Inform 7 build 6M62 (I6/v6.33 lib 6/12N) SD

Front Porch
There is an abandoned house in front of you. All the windows and doors are boarded up. There seems to be no entry from this side of the house.

>go east
A couple racoons scurry away as you turn the corner
You can't go that way.

* * *

CSC 378 Project 1
An Interactive Fiction by Koichi
Release 1 / Serial number 220111 / Inform 7 build 6M62 (I6/v6.33 lib 6/12N) SD

Front Porch
There is an abandoned house in front of you. All the windows and doors are boarded up. There seems to be no entry from this side of the house.

>east
East side of the House
 A couple racoons scurry away as you turn the corner.  You are facing the East side of the house. There is a knocked over trash can that the racoons were looting.

You can see a knife here.

>s
You can't go that way.

>w
Front Porch
There is an abandoned house in front of you. All the windows and doors are boarded up. There seems to be no entry from this side of the house.

>e
RightHouse
You are facing the East side of the house.

* * *

>east
East side of the House
 A couple racoons scurry away as you turn the corner.  You are facing the East side of the house. There is a knocked over trash can that the racoons were looting.

You can see a knife here.

>w
Front Porch
There is an abandoned house in front of you. All the windows and doors are boarded up. There seems to be no entry from this side of the house.

>e
RightHouse
 You are facing the East side of the house.

* * *

>east
East side of the House
 A couple racoons scurry away as you turn the corner.  You are facing the East side of the house. There is a knocked over trash can that the racoons were looting.

You can see a knife here.

>take knife
Taken. You see nothing special about the knife.

>look
East side of the House
 You are facing the East side of the house. There is a knocked over trash can that the racoons were looting.

>x trash can
Trash can is empty.

* * *

>east
East side of the House
 A couple racoons scurry away as you turn the corner.  You are facing the East side of the house. There is a knocked over trash can that the racoons were looting.

You can see a knife here.

>x trashcans
You can't see any such thing.

>x trash cans
You see nothing special about trash cans.

>x trash can
I only understood you as far as wanting to examine trash cans.

* * *

>east
East side of the House
 A couple racoons scurry away as you turn the corner.  You are facing the East side of the house. There is a knocked over trash can that the racoons were looting.

You can see a knife here.

>take trash cans
Taken.

* * *

>east
East side of the House
 A couple racoons scurry away as you turn the corner.  You are facing the East side of the house. There is a knocked over trash can that the racoons were looting.

You can see a knife here.

>x trash can
There is only rotten food and a rusty knife in here.

In trash can is rotten food.

>x knife
You can't see any such thing.

>x rotten food
You see nothing special about rotten food.

* * *

>x trash can
There is only rotten food and a rusty knife in here.

In trash can is rotten food.

>take knife
That's hardly portable.

* * *

>x trash can
There is only rotten food and a rusty knife in here.

In trash can is rotten food.

>take rotten food
That's hardly portable.

>take knife
You can't see any such thing.

* * *

>x trash can
There is only rotten food and a rusty knife in here.

In trash can is rotten food.

>take rotten food
Taken. You see nothing special about rotten food.

* * *

>east
East side of the House
 A couple racoons scurry away as you turn the corner.  You are facing the East side of the house. There is a knocked over trash can that the racoons were looting.

You can see a knife here.

>go into trash can
That's not something you can enter.

>x trash can
There is only Rotten food and a knife in here.

In trash can are a knife and rotten food.

* * *

>east
East side of the House
 A couple racoons scurry away as you turn the corner.  You are facing the East side of the house. There is a knocked over trash can that the racoons were looting.

You can see a knife here.

>take knife
You can't see any such thing.

>x trash can
There is only rotten food and a rusty knife in here.

>take knife
You can't see any such thing.

* * *

CSC 378 Project 1
An Interactive Fiction by Koichi
Release 1 / Serial number 220111 / Inform 7 build 6M62 (I6/v6.33 lib 6/12N) SD

Front Porch
There is an abandoned house in front of you. All the windows and doors are boarded up. There seems to be no entry from this side of the house.

>e
East side of the House
 A couple racoons scurry away as you turn the corner.  You are facing the East side of the house. There is a knocked over trash can that the racoons were looting.

>look
RightHouse
 You are facing the East side of the house. There are knocked over trash cans that the racoons were looting.

* * *

>e
East side of the House
 A couple racoons scurry away as you turn the corner.  You are facing the East side of the house. There is a knocked over trash can that the racoons were looting.

>x trash can
There is only rotten food and a rusty knife in here.

In trash can is a knife.

* * *

CSC 378 Project 1
An Interactive Fiction by Koichi
Release 1 / Serial number 220111 / Inform 7 build 6M62 (I6/v6.33 lib 6/12N) SD

Front Porch
There is an abandoned house in front of you. All the windows and doors are boarded up. There seems to be no entry from this side of the house.

>x house
You see nothing special about house.

>go east
East side of the House
 A couple racoons scurry away as you turn the corner.  You are facing the East side of the house. There is a knocked over trash can that the racoons were looting.

* * *

CSC 378 Project 1
An Interactive Fiction by Koichi
Release 1 / Serial number 220111 / Inform 7 build 6M62 (I6/v6.33 lib 6/12N) SD

Front Porch
There is an abandoned house in front of you. All the windows and doors are boarded up. There seems to be no entry from this side of the house.

>go east
East side of the House
 A couple racoons scurry away as you turn the corner.  You are facing the East side of the house. There is a knocked over trash can that the racoons were looting.

>x trash can
There is only rotten food and a knife in here.

In trash can is a knife.

* * *

>go east
East side of the House
 A couple racoons scurry away as you turn the corner.  You are facing the East side of the house. There is a knocked over trash can that the racoons were looting.

>look
East side of the House
 You are facing the East side of the house. There is a knocked over trash can that the racoons were looting.

>x trash can
There is only rotten food and a rusty knife in here.

In trash can is a knife.

* * *

CSC 378 Project 1
An Interactive Fiction by Koichi
Release 1 / Serial number 220111 / Inform 7 build 6M62 (I6/v6.33 lib 6/12N) SD

Front Porch
There is an abandoned house in front of you. All the windows and doors are boarded up. There seems to be no entry from this side of the house.

>look
Front Porch
There is an abandoned house in front of you. All the windows and doors are boarded up. There seems to be no entry from this side of the house.