Gaea's Cradle
Tall old trees surround you, towering over the sky, watching over the bending path. The bending path continues north for miles ahead. To the west, among the path, you see an old shrine. Behind you is your hometown, Allune. To your right in the East, you see a long beaten trail that goes deep into the woods. You packed all you needed for your journey in your backpack.

>test me
>--> No test scripts exist for this game.

* * *

Gaea's Cradle
Tall old trees surround you, towering over the sky, watching over the bending path. The bending path continues north for miles ahead. To the west, among the path, you see an old shrine. Behind you is your hometown, Allune. To your right in the East, you see a long beaten trail that goes deep into the woods. You packed all you needed for your journey in your backpack.

>s
You take a few steps into your hometown, but something at the back of your head reminds you, "go find your grandmother..."

Allune
A town where you currently live. Populated by peasants, there is not much infrastructure aside from the postal office. There is a field full of fruit south of the town.

>w
Shrine
The broken shrine appears to be old and covered in moss.

>e
Gaea's Cradle

>e
The Beaten Path
It's a dirty, beaten path that looks like it leads somewhere.

>e
The Thieve's Den
A dilapidated building in the middle of the forest.

You can see a Thief here.

You were attacked by a boar!

    *** The Theif has stopped you. You suddenly feel light headed... The Theif has stabbed you! He steals all your stuff as you begin to bleed out into white... ***

Would you like to RESTART, RESTORE a saved game, QUIT, or UNDO the last command?

>restart
Gaea's Cradle
Tall old trees surround you, towering over the sky, watching over the bending path. The bending path continues north for miles ahead. To the west, among the path, you see an old shrine. Behind you is your hometown, Allune. To your right in the East, you see a long beaten trail that goes deep into the woods. You packed all you needed for your journey in your backpack.

>s
You take a few steps towards your hometown, but remembering that you have to see Grandmother, you return to the path.

>w
Shrine
The broken shrine appears to be old and covered in moss.

* * *

>e
The Beaten Path
It's a dirty, beaten path that looks like it leads somewhere.

>w
Gaea's Cradle

>s
You take a few steps towards your hometown, but remembering that you have to see Grandmother, you return to the path.

>s
You take a few steps towards your hometown, but remembering that you have to see Grandmother, you return to the path.

>e
The Beaten Path

>n
You can't go that way.

>w
Gaea's Cradle

>n
Gaea's End
The end of the forest that leads a lavish city.

>s
Gaea's Cradle
You are startled by a bird and run into a tree.

>eat apple
(first taking the apple)
You eat the apple. Not bad.

>n
Gaea's End
You were attacked by a boar!

>n
Lynesera
The path from the south ends at the silver gates, leading to a path into a city built into the base of a large Deku tree.

You can see Grandmother here.

    *** You met your Grandmother. ***

Would you like to RESTART, RESTORE a saved game, QUIT, or UNDO the last command?

* * *

>s
You take a few steps into your hometown, but something at the back of your head reminds you, "go find your grandmother..."

Allune
A town where you currently live. Populated by peasants, there is not much infrastructure aside from the postal office. There is a field full of fruit south of the town.

>look
Allune
A town where you currently live. Populated by peasants, there is not much infrastructure aside from the postal office.

>n
Gaea's Cradle
You were attacked by a boar!

>eat apple
(first taking the apple)
You eat the apple. Not bad.

>s
You take a few steps into your hometown, but something at the back of your head reminds you, "go find your grandmother..."

Allune

>look
Allune
A town where you currently live. Populated by peasants, there is not much infrastructure aside from the postal office.

>x postal office
You can't see any such thing.

>n
Gaea's Cradle

>w
You cannot go there. But you can admire the shrine.

>x shrine
You can't see any such thing.

* * *

>s
You take a few steps into your hometown, but something at the back of your head reminds you, "go find your grandmother..."

Allune
A town where you currently live. Populated by peasants, there is not much infrastructure aside from the postal office. There is a field full of fruit south of the town.

>s
Field
The field is full of fresh and tasty fruit! Only take a couple or the villagers will be upset...

You can see a raspberry, a blackberry, and a blueberries here.

>take all
raspberry: Taken.
blackberry: Taken.
blueberries: Taken.

>i
You are carrying:
  a blueberries
  a blackberry
  a raspberry
  a backpack (open)
    an apple
    a letter
  a silver key

You are startled by a bird and run into a tree.

>put blueberry in backpack
You can't see any such thing.

>x letter
Your grandmother who lives in Lynesera. She wrote to you to come and visit because she misses you dearly.

* * *

>take all
raspberry: Taken.
blackberry: Taken.
blueberries: Taken.

>n
Allune

>n
Gaea's Cradle

>n
Gaea's End
The end of the forest that leads a lavish city.

You can see a gate here.

>n
(first opening the gate)
It seems to be locked.

>unlock gate
What do you want to unlock the gate with?

>key
You can't see any such thing.

>i
You are carrying:
  a blueberries
  a blackberry
  a raspberry
  a backpack (open)
    an apple
    a letter

>s
Gaea's Cradle

>w
Shrine
The broken shrine appears to be old and covered in moss.

You can see a silver key here.

>take key
Taken.

>w
You can't go that way.

>e
Gaea's Cradle

>n
Gaea's End
You can see a gate here.

You were attacked by a boar!

>eat apple
(first taking the apple)
You eat the apple. Not bad.

>unlock gate
What do you want to unlock the gate with?

>key
You unlock the gate.

>n
(first opening the gate)

Lynesera
The path from the south ends at the silver gates, leading to a path into a city built into the base of a large Deku tree.

You can see a gate and Grandmother here.

    *** You met your Grandmother. ***

Would you like to RESTART, RESTORE a saved game, QUIT, or UNDO the last command?

>retart
Please give one of the answers above.

Would you like to RESTART, RESTORE a saved game, QUIT, or UNDO the last command?

>restart
Gaea's Cradle
Tall old trees surround you, towering over the sky, watching over the bending path. The bending path continues north for miles ahead. To the west, among the path, you see an old shrine. Behind you is your hometown, Allune. To your right in the East, you see a long beaten trail that goes deep into the woods. You packed all you needed for your journey in your backpack.

>n
Gaea's End
The end of the forest that leads a lavish city.

You can see a gate here.

* * *

>n
(first opening the gate)
It seems to be locked.

>s
Gaea's Cradle

>s
You take a few steps into your hometown, but something at the back of your head reminds you, "go find your grandmother..."

Allune
A town where you currently live. Populated by peasants, there is not much infrastructure aside from the postal office. There is a field full of fruit south of the town.

* * *

>take all
raspberry: Taken.
blackberry: Taken.
blueberries: Taken.

>n
Allune
Ouch! You tripped on a rock.

>n
Gaea's Cradle

>eat apple
(first taking the apple)
You eat the apple. Not bad.

>i
You are carrying:
  a blueberries
  a blackberry
  a raspberry
  a backpack (open)
    a letter

>w
Shrine
The broken shrine appears to be old and covered in moss.

You can see a silver key here.

>take silver key
Taken.

>n
You can't go that way.

>e
Gaea's Cradle

>n
Gaea's End
You can see a gate here.

>unlock gate
What do you want to unlock the gate with?

* * *

Gaea's Cradle
Tall old trees surround you, towering over the sky, watching over the bending path. The bending path continues north for miles ahead. To the west, among the path, you see an old shrine. Behind you is your hometown, Allune. To your right in the East, you see a long beaten trail that goes deep into the woods. You packed all you needed for your journey in your backpack.

>x shrine
You can't see any such thing.

* * *

Gaea's Cradle
Tall old trees surround you, towering over the sky, watching over the bending path. The bending path continues north for miles ahead. To the west, among the path, you see an old shrine. Behind you is your hometown, Allune. To your right in the East, you see a long beaten trail that goes deep into the woods. You packed all you needed for your journey in your backpack.

>west
Shrine
The broken shrine appears to be old and covered in moss.

Ouch! You tripped on a rock.

>inventory
You are carrying:
  a backpack (open)
    an apple
    a letter
  a silver key

>eat apple
(first taking the apple)
You eat the apple. Not bad.

* * *

>west
Shrine
The broken shrine appears to be old and covered in moss.

Ouch! You tripped on a rock.

>west
You can't go that way.

>east
Gaea's Cradle
You were attacked by a boar!

    *** You have sustained too many injuries. You have died. ***

Would you like to RESTART, RESTORE a saved game, QUIT, or UNDO the last command?

>restart
Gaea's Cradle
Tall old trees surround you, towering over the sky, watching over the bending path. The bending path continues north for miles ahead. To the west, among the path, you see an old shrine. Behind you is your hometown, Allune. To your right in the East, you see a long beaten trail that goes deep into the woods. You packed all you needed for your journey in your backpack.

>e
The Beaten Path
It's a dirty, beaten path that looks like it leads somewhere.

>e
The Thieve's Den
A dilapidated building in the middle of the forest.

You can see a Thief here.

    *** The Theif has stopped you. You suddenly feel light headed... The Theif has stabbed you! He steals all your stuff as you begin to bleed out into white... ***

Would you like to RESTART, RESTORE a saved game, QUIT, or UNDO the last command?

* * *

Gaea's Cradle
Tall old trees surround you, towering over the sky, watching over the bending path. The bending path continues north for miles ahead. To the west, among the path, you see an old shrine. Behind you is your hometown, Allune. To your right in the East, you see a long beaten trail that goes deep into the woods. You packed all you needed for your journey in your backpack.

>go west
You cannot go there. But you can admire the shrine.

>w
You can't go that way.

* * *

>go west
You cannot go there. But you can admire the shrine.

>so south
That's not a verb I recognize.

>s
You take a few steps towards your hometown, but remembering that you have to see Grandmother, you return to the path.

>look
Allune
A town where you currently live. Populated by peasants, there is not much infrastructure aside from the postal office.

* * *

Gaea's Cradle
Tall old trees surround you, towering over the sky, watching over the bending path. The bending path continues north for miles ahead. To the west, among the path, you see an old shrine. Behind you is your hometown, Allune. To your right in the East, you see a long beaten trail that goes deep into the woods. You packed all you needed for your journey in your backpack.

>w
Shrine
The broken shrine appears to be old and covered in moss.

You can see a silver key here.

>x shrine
You can't see any such thing.

>look at shrine
You can't see any such thing.

>look west
You see nothing unusual in that direction.

* * *

>w
Shrine
The broken shrine appears to be old and covered in moss.

You can see a silver key here.

>x shine
You can't see any such thing.

>look at shrine
You can't see any such thing.

>e
The Beaten Path
It's a dirty, beaten path that looks like it leads somewhere.

>look e
You see nothing unusual in that direction.

>x west
You see nothing unexpected in that direction.

* * *

>w
Shrine
The broken shrine appears to be old and covered in moss.

You can see a silver key here.

I beg your pardon?

>w
You can't go that way.

* * *

Gaea's Cradle
Tall old trees surround you, towering over the sky, watching over the bending path. The bending path continues north for miles ahead. To the west, among the path, you see an old shrine. Behind you is your hometown, Allune. To your right in the East, you see a long beaten trail that goes deep into the woods. You packed all you needed for your journey in your backpack.

>go w
You can't go that way.

>go w
You can't go that way.

* * *

>x west
You see nothing unexpected in that direction.

>x shrine
You can't see any such thing.

* * *

Gaea's Cradle
Tall old trees surround you, towering over the sky, watching over the bending path. The bending path continues north for miles ahead. To the west, among the path, you see an old shrine. Behind you is your hometown, Allune. To your right in the East, you see a long beaten trail that goes deep into the woods. You packed all you needed for your journey in your backpack.

>east
The Beaten Path
It's a dirty, beaten path that looks like it leads somewhere.

>east
The Thieve's Den
A dilapidated building in the middle of the forest.

You can see a Thief here.

>x theif
You can't see any such thing.

>look theif
You can't see any such thing.

>x the thief
Someone who wants to rob you!

>x thief
Someone who wants to rob you!

>x building
You can't see any such thing.

>look
The Thieve's Den
A dilapidated building in the middle of the forest.

You can see a Thief here.

>look at building
You can't see any such thing.

* * *

Gaea's Cradle
Tall old trees surround you, towering over the sky, watching over the bending path. The bending path continues north for miles ahead. To the west, among the path, you see an old shrine. Behind you is your hometown, Allune. To your right in the East, you see a long beaten trail that goes deep into the woods. You packed all you needed for your journey in your backpack.

>e
The Beaten Path
It's a dirty, beaten path that looks like it leads somewhere.

>e
The Thieve's Den
A dilapidated building in the middle of the forest.

You can see a building and a Thief here.

>x building
You see nothing special about the building.

>look
The Thieve's Den
A dilapidated building in the middle of the forest.

You can see a building and a Thief here.

>x thief
Someone who wants to rob you!

>w
*** The Theif has stopped you. You suddenly feel light headed... The Theif has stabbed you! He steals all your stuff as you begin to bleed out into white... ***

Would you like to RESTART, RESTORE a saved game, QUIT, or UNDO the last command?

>restart
Gaea's Cradle
Tall old trees surround you, towering over the sky, watching over the bending path. The bending path continues north for miles ahead. To the west, among the path, you see an old shrine. Behind you is your hometown, Allune. To your right in the East, you see a long beaten trail that goes deep into the woods. You packed all you needed for your journey in your backpack.

>n
Gaea's End
The end of the forest that leads a lavish city.

>n
Lynesera
The path from the south ends at the silver gates, leading to a path into a city built into the base of a large Deku tree.

You can see Grandmother here.

    *** You met your Grandmother. ***

Would you like to RESTART, RESTORE a saved game, QUIT, or UNDO the last command?

* * *

>e
The Beaten Path
It's a dirty, beaten path that looks like it leads somewhere.

>w
Gaea's Cradle
You are startled by a bird and run into a tree.

>w
Shrine
The broken shrine appears to be old and covered in moss.

You can see a silver key here.

>eat apple
(first taking the apple)
You eat the apple. Not bad.

>take silver key
Taken.

>w
You can't go that way.

>e
Gaea's Cradle
Ouch! You tripped on a rock.

>n
Gaea's End
The end of the forest that leads a lavish city.

You can see a gate here.

You were attacked by a boar!

    *** You have sustained too many injuries. You have died. ***

Would you like to RESTART, RESTORE a saved game, QUIT, or UNDO the last command?

>restart
Gaea's Cradle
Tall old trees surround you, towering over the sky, watching over the bending path. The bending path continues north for miles ahead. To the west, among the path, you see an old shrine. Behind you is your hometown, Allune. To your right in the East, you see a long beaten trail that goes deep into the woods. You packed all you needed for your journey in your backpack.

* * *

Gaea's Cradle
Tall old trees surround you, towering over the sky, watching over the bending path. The bending path continues north for miles ahead. To the west, among the path, you see an old shrine. Behind you is your hometown, Allune. To your right in the East, you see a long beaten trail that goes deep into the woods. You packed all you needed for your journey in your backpack.

>n
Gaea's End
The end of the forest that leads a lavish city.

You can see a gate here.

* * *

>n
(first opening the gate)
It seems to be locked.

>x gate
A huge metal gate stands between you and the city ahead.

Ouch! You tripped on a rock.